from_pobj_tree	eat_nsubj_giraffes	in_pobj_wild	
in_pobj_basket	in_pobj_room
near_pobj_grass	paved_nsubj_crossing	paved_dobj_road
extends_nsubj_player	extends_dobj_racket	hit_dobj_ball
standing_nsubj_girl	to_pobj_motorcycles
on_pobj_platform	on_pobj_motorcycle
to_pobj_pole	sign_nsubj_stop
in_pobj_kitchen
at_pobj_night	of_pobj_people	taking_dobj_photo
in_pobj_arms	of_pobj_bear
washing_dobj_car	washing_nsubj_woman	with_pobj_hose
to_pobj_machines	hooded_nsubj_woman	in_pobj_bed
near_pobj_bird
using_dobj_skateboard	perform_dobj_tricks	using_nsubj_male
in_pobj_Asia
on_pobj_buttocks	with_pobj_hat	to_pobj_person
on_pobj_top	is_nsubj_sandwich	of_pobj_plate
at_pobj_something	in_pobj_photo
in_pobj_carriage	pulling_dobj_people	on_pobj_street	pulling_nsubj_horse
standing_nsubj_sheep	in_pobj_field
against_pobj_window	in_pobj_terminal	with_pobj_jet
in_pobj_vase	sitting_nsubj_bear	with_pobj_flowers
in_pobj_fashion
on_pobj_road	moped_nsubj_man	with_pobj_helmet
at_pobj_shop
at_pobj_restaurant	to_pobj_water
under_pobj_cabana	using_dobj_phone	sitting_nsubj_woman
of_pobj_croissants	with_pobj_spoon	of_pobj_cocoa
of_pobj_rooster
on_pobj_chair	at_pobj_ground
on_pobj_street	with_pobj_pictures	on_pobj_it
in_pobj_park	of_pobj_bench
at_pobj_station
in_pobj_grass	standing_nsubj_lamb
stacked_nsubj_book	on_pobj_top	of_pobj_it	with_pobj_supplies
at_pobj_place	luggage_nsubj_People
on_pobj_field	behind_pobj_fence
in_pobj_front	from_pobj_bottle	of_pobj_group	of_pobj_people
on_pobj_runway
among_pobj_lines
on_pobj_sidewalk	riding_dobj_skateboard
on_pobj_top	of_pobj_snow
on_pobj_scooters	of_pobj_people	of_pobj_them
playing_dobj_match	on_pobj_court	of_pobj_tennis
on_pobj_plate	with_pobj_ham
has_nsubj_airplane	on_pobj_tarmac	has_dobj_workers	in_pobj_vests	near_pobj_it
in_pobj_air	on_pobj_block
to_pobj_couch	in_pobj_den
by_pobj_species
of_pobj_carrot	with_pobj_noodles
up_pobj_street	walking_nsubj_bunch	of_pobj_people
in_pobj_area	with_pobj_equipment
in_pobj_air	doing_dobj_trick
carrying_dobj_surfboard	on_pobj_beach
grated_dobj_cheese	with_pobj_shrimp	of_pobj_dish
of_pobj_chicken	on_pobj_plate	with_pobj_broccoli
with_pobj_window	features_nsubj_room	features_dobj_set
of_pobj_beer	to_pobj_glass
on_pobj_side	of_pobj_road
around_pobj_it	with_pobj_torches
lined_dobj_park	like_pobj_area	at_pobj_curb	lined_nsubj_vehicles	near_pobj_tree
on_pobj_it	of_pobj_street	has_nsubj_sidewalk
has_dobj_laptop	at_pobj_desk	with_pobj_man	on_pobj_wall
of_pobj_bread	of_pobj_soup	of_pobj_bowl
down_nsubj_man	on_pobj_rides
on_pobj_toothrbush
of_pobj_zebra	of_pobj_herd	in_pobj_wild
in_pobj_seat	of_pobj_car
on_pobj_laptops	in_pobj_bed
on_pobj_hill	with_pobj_tree
on_pobj_chair
of_pobj_elephant	on_pobj_back
to_pobj_refrigerator	oscillating_dobj_fan
covered_nsubj_woman	on_pobj_snow	riding_dobj_skis	covered_dobj_slope
complete_dobj_look	wears_nsubj_man	wears_dobj_watch
to_pobj_bathtub	with_pobj_screen
behind_pobj_horse	standing_nsubj_men
to_pobj_sign
on_pobj_couch
at_pobj_door	standing_nsubj_woman
of_pobj_badminton	playing_dobj_game	of_pobj_kids
in_pobj_line	in_pobj_sky
with_pobj_shade
playing_dobj_game	of_pobj_people
cross_nsubj_person	in_pobj_jacket	by_pobj_mountains
on_pobj_beach	holding_dobj_discs	holding_nsubj_who
on_pobj_path	over_pobj_field
on_pobj_couch	with_pobj_remote	on_pobj_arm
with_pobj_tub
on_pobj_chair	on_pobj_cat	lays_nsubj_Woman	lays_dobj_head
on_pobj_tracks	at_pobj_station	sitting_nsubj_cars
in_pobj_ocean	near_pobj_lighthouse
standing_nsubj_man	with_pobj_board
on_pobj_top	of_pobj_tarmac
on_pobj_table	in_pobj_bag	with_pobj_sticks	in_pobj_it	sits_nsubj_Food
of_pobj_food	on_pobj_table
to_pobj_calf	in_pobj_meadow
in_pobj_front	of_pobj_mountain	on_pobj_post
on_pobj_laptop	watching_dobj_video	in_pobj_bed
with_pobj_bananas	on_pobj_river
through_pobj_field
in_pobj_front	of_pobj_food	of_pobj_keyboard
taking_dobj_swing	at_pobj_ball
through_pobj_field	in_pobj_background	of_pobj_cattle	run_nsubj_heard
on_pobj_boards	at_pobj_park	of_pobj_kids
surfing_nsubj_man	in_pobj_ocean	in_pobj_shorts
with_pobj_chairs	on_pobj_wall
toasts_dobj_crowd	in_pobj_attire	toasts_nsubj_couple
in_pobj_front	with_pobj_floor
of_pobj_signs	with_pobj_lots
on_pobj_bench	sits_nsubj_dog	to_pobj_pumpkin
on_pobj_beach	shows_nsubj_photo	behind_pobj_curtain	shows_dobj_someone
sitting_nsubj_couple	around_pobj_table	of_pobj_people
to_pobj_bag	with_pobj_strawberries
rowing_dobj_boat	with_pobj_dog
near_pobj_trees	riding_dobj_track
with_pobj_laptops
in_pobj_basket	are_nsubj_bananas
on_pobj_railing
near_pobj_stop	on_pobj_phone
wearing_dobj_turbans	on_pobj_street	of_pobj_men
with_pobj_computers	on_pobj_it
with_pobj_flowers	on_pobj_it
with_pobj_fruit
near_pobj_berries	sits_nsubj_bird	on_pobj_branch
riding_dobj_wave	in_pobj_water
of_pobj_food	on_pobj_table	of_pobj_plate
of_pobj_bananas	with_pobj_tips
on_pobj_tracks	above_pobj_street
eating_dobj_barbecue
of_pobj_motorcycle
on_pobj_top	of_pobj_car
down_pobj_snow	covered_nsubj_person	riding_dobj_snowboard	covered_dobj_slope
in_pobj_background	of_pobj_signs	with_pobj_buildings
wearing_dobj_jackets	in_pobj_snow
with_pobj_couches
face_nsubj_elephant	face_dobj_paint
in_pobj_background	in_pobj_foreground	with_pobj_oranges	of_pobj_apple
in_pobj_middle	rides_dobj_horse	rides_nsubj_woman	of_pobj_street
on_pobj_top	stands_nsubj_woman	to_pobj_fridge	has_dobj_glasses
to_pobj_ocean	on_pobj_hillside
with_pobj_jockeys	pushing_dobj_them
sits_nsubj_laptop	upon_pobj_desk
in_pobj_snow	on_pobj_skis
contains_nsubj_room	contains_dobj_desk	with_pobj_television
with_pobj_furniture	on_pobj_desk
of_pobj_suitcases	in_pobj_pile	of_pobj_number
with_pobj_case	of_pobj_it	to_pobj_handle
on_pobj_sidewalk
in_pobj_building	in_pobj_background	with_pobj_giraffe
in_pobj_median	displaying_dobj_ad	displaying_nsubj_sign	of_pobj_woman
on_pobj_top	of_pobj_water
of_pobj_bus	of_pobj_street
with_pobj_racquet	hitting_dobj_ball
with_pobj_racket	hitting_dobj_ball	hitting_nsubj_man
eat_dobj_dog
throwing_dobj_bat	hitting_dobj_ball
with_pobj_collar	in_pobj_suit
on_pobj_sausage	with_pobj_breast	hanging_nsubj_woman
has_dobj_spread	sitting_nsubj_girl	on_pobj_bed
wearing_dobj_vest	wearing_dobj_tie	with_pobj_smile	on_pobj_face
down_pobj_street	of_pobj_motorcycles	travel_nsubj_group
behind_pobj_child	stands_nsubj_man	with_pobj_bat
holding_dobj_controller	on_pobj_laptop
on_pobj_laptop	in_pobj_room
in_pobj_trunks	is_nsubj_skier
with_pobj_head	of_pobj_window
of_pobj_people	watching_dobj_game
on_pobj_course	ski_nsubj_competitors
of_pobj_people	covered_nsubj_group	down_pobj_snow	riding_dobj_skis	covered_dobj_slope
near_pobj_table	in_pobj_corner	dinning_dobj_table	of_pobj_room
in_pobj_kitchen	of_pobj_people
sail_nsubj_kites	in_pobj_sky
with_pobj_graffiti	on_pobj_sreet	on_pobj_it
containing_dobj_produce
atop_pobj_dresser	sit_nsubj_pieces	of_pobj_luggage
of_pobj_building
of_pobj_water	in_pobj_boat	in_pobj_middle
with_pobj_lot	of_pobj_people	on_pobj_it
on_pobj_counter	of_pobj_tools
sits_nsubj_computer	on_pobj_desk
on_pobj_top	without_pobj_shirt	preparing_dobj_chicken	of_pobj_BBQ
on_pobj_beach	drawn_nsubj_horse	on_pobj_horseback	drawn_dobj_carriages
listing_dobj_flights	at_pobj_airport
at_pobj_ocean	catching_nsubj_man	catching_dobj_wave

on_pobj_top	of_pobj_train	through_pobj_hillside
from_pobj_it	with_pobj_person	on_pobj_pan
wearing_dobj_blanket
earing_dobj_hat	on_pobj_lap
at_pobj_table	with_pobj_soup
on_pobj_photo	of_pobj_cheifs
walking_nsubj_lot	down_pobj_sidewalk	of_pobj_people	to_pobj_road
with_pobj_flower
with_pobj_fridge
by_pobj_leaves	standing_nsubj_woman	with_pobj_umbrella
displayed_nsubj_vase	on_pobj_table	with_pobj_flower
in_pobj_grass
provide_dobj_caption
in_pobj_jacket	on_pobj_slope
using_dobj_mouse	at_pobj_desk
in_pobj_head	leaves_nsubj_boat	leaves_dobj_shore
against_pobj_wall	in_pobj_shirt
on_pobj_tarmac	Looking_dobj_window	at_pobj_airport	to_pobj_activity
on_pobj_floor
in_pobj_game
bunting_dobj_baseball	with_pobj_bat
by_pobj_keyboard	with_pobj_muzzle
with_pobj_bed
with_pobj_windows	of_pobj_room
on_pobj_ground	of_pobj_park	on_pobj_skateboard
in_pobj_background	with_pobj_mountains	over_pobj_ground	stands_nsubj_horse
of_pobj_suitcase	on_pobj_handle	with_pobj_hand
in_pobj_background	by_pobj_chairs	with_pobj_woods
riding_dobj_motorcycle	on_pobj_phone
from_pobj_hydrant	enjoying_dobj_themselves	of_pobj_people	enjoying_nsubj_number	around_pobj_fountain
eat_nsubj_she	sticking_dobj_head	eat_dobj_hay	through_pobj_gate
with_pobj_controller
walking_nsubj_who	across_pobj_street
sets_dobj_kite	on_pobj_beach	sets_nsubj_man
near_pobj_grass	on_pobj_walkway
through_pobj_doors	with_pobj_floor
in_pobj_area	to_pobj_water	of_pobj_elephants
of_pobj_boy	by_pobj_rope	leading_dobj_cow
of_pobj_branch	on_pobj_top
of_pobj_water	wearing_dobj_hat	to_pobj_body

on_pobj_beach	playing_dobj_frisbee
to_pobj_cat	holding_dobj_donut
performing_nsubj_group	of_pobj_athletes	in_pobj_field
sits_nsubj_man	in_pobj_front	of_pobj_oven	cooking_nsubj_what
lying_nsubj_boy	in_pobj_park	on_pobj_bench
stopped_nsubj_strains	to_pobj_tracks	at_pobj_station
walking_nsubj_people	on_pobj_streets	riding_dobj_bicycles
on_pobj_street
down_pobj_hill	skinning_nsubj_skiers
from_pobj_perspective
behind_pobj_seat	sitting_nsubj_dog	of_pobj_car
in_pobj_groups	on_pobj_grass	congregate_nsubj_people	of_pobj_them
offloading_dobj_baggage	offloading_nsubj_people	at_pobj_airport	with_pobj_names
like_pobj_truck
onto_pobj_cake
of_pobj_elephants
on_pobj_tracks	in_pobj_woods
in_pobj_background	on_pobj_right	on_pobj_floor	with_pobj_passageway
sleeping_nsubj_bear	on_pobj_snow
on_pobj_boat	holding_dobj_seafood
has_dobj_engines
before_pobj_set	of_pobj_lighting	in_pobj_room
riding_dobj_surfboard	to_pobj_water	Surfing_dobj_girl
of_pobj_building	of_pobj_horse	to_pobj_carriage	in_pobj_front
on_pobj_step
in_pobj_front	of_pobj_pizza
in_pobj_field	on_pobj_board	is_nsubj_man
with_pobj_computer	on_pobj_it
with_pobj_crowd	on_pobj_court	swinging_nsubj_person	hit_dobj_ball
down_pobj_tracks	into_pobj_station
with_pobj_sink
holding_dobj_clock
sits_nsubj_bed	with_pobj_leg
on_pobj_side	with_pobj_flower
in_pobj_jacket	biting_dobj_sandwich	biting_nsubj_girl
with_pobj_bin	off_pobj_pen
near_pobj_buildings	in_pobj_snow	on_pobj_street	by_pobj_meters
in_pobj_kitchen	of_pobj_folks
in_pobj_snow	on_pobj_skis
to_pobj_man	over_pobj_cake	with_pobj_sword
watching_dobj_player	at_pobj_game	watching_nsubj_People
on_pobj_bench
to_pobj_board
lying_nsubj_kitten	on_pobj_keyboard	of_pobj_laptop
shows_nsubj_corner	shows_dobj_clock	on_pobj_post
on_pobj_court	holding_dobj_racquet
for_pobj_picture	of_pobj_kids
with_pobj_signs	to_pobj_it	sign_nsubj_stop
of_pobj_pillows	to_pobj_bed	with_pobj_lots
playing_dobj_game	wearing_dobj_helmet
down_pobj_street	riding_dobj_skateboard
with_pobj_water	on_pobj_table
at_pobj_restaurant	of_pobj_women	sitting_nsubj_group

with_pobj_couch	on_pobj_rug	in_pobj_room
riding_nsubj_man	riding_dobj_surfboard	over_pobj_waves
in_pobj_jacket	on_pobj_street
of_pobj_style	near_pobj_curb	parked_nsubj_mopeds
of_pobj_food	on_pobj_tablecloth	sit_nsubj_plates
in_pobj_grass
in_pobj_middle	on_pobj_wave	of_pobj_lake
of_pobj_cake	in_pobj_front
ridding_dobj_skateboard	up_pobj_ramp	at_pobj_park
in_pobj_carrier	inside_pobj_coat	sleeps_nsubj_dog
on_pobj_pole	on_pobj_day
with_pobj_spots	of_pobj_stable	on_pobj_it
of_pobj_kayaks	on_pobj_flats	at_pobj_edge
throws_nsubj_player	make_dobj_serve	throws_dobj_ball
of_pobj_horse	falling_nsubj_man
holding_dobj_flag	riding_dobj_horse
in_pobj_pasture	grazing_nsubj_Horses	behind_pobj_fence
on_pobj_beach	with_pobj_lounges
of_pobj_buses	down_pobj_it	with_pobj_lots
holds_nsubj_hand	holds_nsubj_dog	holds_dobj_side	of_pobj_Frisbee
down_pobj_street	with_pobj_helmet	riding_dobj_motorcycle
of_pobj_donuts	in_pobj_front	for_pobj_picture
TO_pobj_GIRAFFE	ARE_nsubj_PEOPLE
with_pobj_horse
at_pobj_table	on_pobj_it	holding_dobj_plate	with_pobj_slice	of_pobj_pizza
in_pobj_background	with_pobj_trees	playing_dobj_frisbee	in_pobj_field
in_pobj_grass	under_pobj_sunlight
holding_dobj_rabbit	on_pobj_table
with_pobj_rice
for_pobj_holidays	features_dobj_tower
picking_dobj_passengers
on_pobj_carpet	with_pobj_remote
at_pobj_plate
on_pobj_sides	of_pobj_it	with_pobj_cars
is_nsubj_person	with_pobj_ball	on_pobj_field
is_nsubj_outhouse
of_pobj_man	on_pobj_surfboard
in_pobj_air	with_pobj_skateboard	doing_dobj_trick
is_nsubj_backyard
near_pobj_court	taking_nsubj_man	from_pobj_refrigerator	taking_dobj_drink
with_pobj_mote
on_pobj_bench	rests_nsubj_case
working_nsubj_man	near_pobj_hydrant
appears_nsubj_what	in_pobj_home	assembling_nsubj_Man
with_pobj_face
in_pobj_front	stands_nsubj_woman	with_pobj_apron	of_pobj_cupboard
is_nsubj_decoration	on_pobj_post
on_pobj_beach	to_pobj_water
of_pobj_us	are_nsubj_lights
from_pobj_sidelines	watch_nsubj_People	as_pobj_rides	on_pobj_skateboard
riding_dobj_surfboard	in_pobj_ocean	on_pobj_wave
in_pobj_woods	in_pobj_sun
near_pobj_sign	parked_nsubj_motorcycle	on_pobj_pavement
of_pobj_monitor	in_pobj_front	with_pobj_laptop
with_pobj_sink
lay_nsubj_People	on_pobj_beach	underneath_pobj_umbrellas
in_pobj_bedroom
at_pobj_hole
in_pobj_front	with_pobj_bench
of_pobj_kangaroos	in_pobj_pasture	of_pobj_them
to_pobj_wall	in_pobj_orange
on_pobj_floor	in_pobj_home	has_dobj_furniture
with_pobj_couches
on_pobj_skis	traversing_nsubj_who	traversing_dobj_terrain
toward_pobj_camera	in_pobj_mouth	with_pobj_Frisbee	running_nsubj_dog
of_pobj_scissors	holding_dobj_pairs
sit_nsubj_people	at_pobj_table	at_pobj_phones
on_pobj_boat	with_pobj_kids
on_pobj_bench	in_pobj_background	with_pobj_tower
near_pobj_river	floating_nsubj_boat	graze_nsubj_cows
using_dobj_controller
on_pobj_spool	of_pobj_wire
at_pobj_conference	distributing_dobj_food
walking_nsubj_Motorcyclists	down_pobj_street	looking_nsubj_people
to_pobj_camera	working_nsubj_person	at_pobj_computer	with_pobj_control
in_pobj_space
sitting_nsubj_tub	in_pobj_bathroom	under_pobj_window
with_pobj_dog	taking_dobj_portrait
with_pobj_bottle	of_pobj_soap	sink_nsubj_bathroom
with_pobj_dog	of_pobj_family	holding_dobj_rackets
with_pobj_stools
on_pobj_bench	with_pobj_luggage	of_pobj_room
in_pobj_sky
on_pobj_posts	in_pobj_lake	sit_nsubj_birds
with_pobj_ketchup	on_pobj_plate
into_pobj_box	of_pobj_doughnuts
in_pobj_area	of_pobj_spaces
with_pobj_boxes
with_pobj_doorways	mounted_nsubj_clock	over_pobj_bench	on_pobj_wall
at_pobj_intersection	on_pobj_building
in_pobj_field	standing_nsubj_group	of_pobj_Zebras
on_pobj_case	descend_nsubj_skateboarder	watches_nsubj_crowd	descend_dobj_rail
reach_dobj_frisbee
at_pobj_table	of_pobj_kids
in_pobj_background	on_pobj_day
from_pobj_it	with_pobj_slices	of_pobj_pizza
is_nsubj_laptop	to_pobj_screen
under_pobj_trees	of_pobj_trucks
of_pobj_bundles	taking_dobj_pictures	with_pobj_lady
of_pobj_table	by_pobj_end
hung_dobj_Animals	hung_nsubj_Someone	from_pobj_top	of_pobj_bridge
with_pobj_outline	around_pobj_floor
in_pobj_front	of_pobj_doughnuts	of_pobj_trays
of_pobj_field	of_pobj_zebras	in_pobj_middle	standing_nsubj_her
on_pobj_bed	at_pobj_laptop
with_pobj_cabinet	with_pobj_towels
is_nsubj_light	see_nsubj_us
of_pobj_group	of_pobj_people
with_pobj_frosting	on_pobj_napkin
on_pobj_sides	of_pobj_street
holds_nsubj_man	holds_dobj_sandwich	wearing_dobj_shirt
to_pobj_airplane	of_pobj_people
of_pobj_boys
across_pobj_snow	walking_nsubj_dog	with_pobj_mouth
at_pobj_night	down_pobj_street
on_pobj_sidewalk	of_pobj_suitcases	grouped_nsubj_view
with_pobj_mother	behind_pobj_him
with_pobj_sheets
at_pobj_table	near_pobj_laptop	with_pobj_ties
of_pobj_dinner	over_pobj_side	is_nsubj_Cheese	pours_nsubj_it
marked_nsubj_graffiti	by_pobj_tank
at_pobj_park	at_pobj_tables	flying_dobj_kites
holding_nsubj_People	passing_dobj_cars	holding_dobj_signs
with_pobj_basics	of_pobj_apartment
IS_nsubj_LADY	ON_pobj_TENNIS
on_pobj_beach	as_pobj_run	on_pobj_horses
spraying_dobj_water	on_pobj_side	of_pobj_road
on_pobj_top	of_pobj_board	on_pobj_lake
in_pobj_rain	with_pobj_umbrella
at_pobj_table	in_pobj_front	with_pobj_dog	of_pobj_her
on_pobj_plane	of_pobj_mechanics
on_pobj_leash	's_nsubj_it
by_pobj_dock	in_pobj_water	is_nsubj_boat
taking_nsubj_man	holding_nsubj_others	holding_dobj_controllers	taking_dobj_photo
finishes_dobj_swing	hitting_dobj_ball	finishes_nsubj_player
of_pobj_food	on_pobj_plate
eating_dobj_doughnut
in_pobj_room
walking_nsubj_bird	on_pobj_sand
makes_nsubj_Man	holding_dobj_pizza	makes_dobj_signals
hit_dobj_ball	trying_nsubj_player
eat_dobj_pizza	on_pobj_table
to_pobj_it	in_pobj_field
with_pobj_board
cross_dobj_channel	at_pobj_barge	of_pobj_water	under_pobj_sky
playing_dobj_softball	on_pobj_field	playing_nsubj_boys
into_pobj_river	entered_nsubj_elephants
in_pobj_office	in_pobj_suits	stand_nsubj_men
to_pobj_fireplace
on_pobj_desk	of_pobj_computers
sit_nsubj_vegetables	in_pobj_bowl
on_pobj_runway	at_pobj_airport
of_pobj_cars	in_pobj_front	of_pobj_house
in_pobj_jacket	riding_dobj_horse
on_pobj_cloth	of_pobj_apples	sits_nsubj_bowl
in_pobj_front	sits_nsubj_plate	with_pobj_sandwich	of_pobj_computer
playing_dobj_soccer	of_pobj_boys
in_pobj_hand	on_pobj_court	with_pobj_racket
is_nsubj_bathroom	use_nsubj_us
WITH_pobj_HELMETS	ON_pobj_MOTORCYCLE
with_pobj_hotdog	holding_dobj_basket
of_pobj_skier	skiing_dobj_snow	covered_nsubj_mob	covered_dobj_side
at_pobj_marsh	drink_nsubj_horse
near_pobj_sign	on_pobj_grass
on_pobj_top	of_pobj_foil
by_pobj_cheese	of_pobj_pasta
with_pobj_controller	playing_dobj_game	in_pobj_room
on_pobj_table	of_pobj_pizza	inside_pobj_restaurant
sitting_dobj_front	of_pobj_cake	sitting_nsubj_kid
on_pobj_beach	on_pobj_surfer
riding_dobj_bike	with_pobj_dog	in_pobj_basket
sits_nsubj_dryer	in_pobj_chair
in_pobj_snow
on_pobj_top	of_pobj_people	covered_nsubj_group	of_pobj_snow	covered_dobj_slope
altered_nsubj_sign	stop_dobj_time	says_nsubj_it
standing_nsubj_girl	on_pobj_runway
at_pobj_hands	passes_nsubj_woman	of_pobj_him	in_pobj_front	in_pobj_coat
on_pobj_grass	walking_nsubj_Sheep	in_pobj_field
under_pobj_umbrellas	with_pobj_lot	of_pobj_chairs
with_pobj_dish	on_pobj_table
line_dobj_street	of_pobj_sign	in_pobj_front	line_nsubj_row	of_pobj_meters
in_pobj_air	in_pobj_suit
with_pobj_hydrants	to_pobj_sign
to_pobj_wall
in_pobj_kitchen	in_pobj_bowl
at_pobj_skies	from_pobj_chairlift
to_pobj_fries	with_pobj_dog
of_pobj_people	with_pobj_umbrellas
on_pobj_cabinets	shows_dobj_appliances	of_pobj_kitchen	shows_nsubj_view
of_pobj_game
beside_pobj_court	in_pobj_shade
cuts_dobj_food	cuts_nsubj_person	with_pobj_knife
sitting_nsubj_man	under_pobj_umbrella
walking_nsubj_People
on_pobj_table
on_pobj_dish	is_nsubj_meal
holds_nsubj_man	on_pobj_it	in_pobj_shirt	holds_dobj_pizza	with_pobj_lettuce
of_pobj_statues	in_pobj_kitchen	of_pobj_people
wearing_dobj_suits	on_pobj_bicycles	wearing_nsubj_men
on_pobj_tracks
holding_dobj_dog	holding_nsubj_woman
of_pobj_children	for_pobj_photo
near_pobj_dock
before_pobj_crowd	standing_nsubj_woman
working_nsubj_baker	in_pobj_dough
to_pobj_candle
in_pobj_house	needs_nsubj_bathroom
of_pobj_juice
stuffing_dobj_donut	in_pobj_mouth	in_pobj_shirt
of_pobj_flowers	in_pobj_bowl
am_nsubj_I	see_dobj_image
carrying_dobj_bag	on_pobj_walk
behind_pobj_car	walking_nsubj_zebras	on_pobj_road
in_pobj_paper
has_dobj_types	of_pobj_fruits
in_pobj_air	above_pobj_ocean
in_pobj_Europe	on_pobj_day
with_pobj_clocks	of_pobj_it	on_pobj_face
holding_dobj_bat
holding_dobj_ball	of_pobj_person
in_pobj_park	beside_pobj_hydrant
under_pobj_blanket	on_pobj_control	resting_dobj_head
on_pobj_bench	near_pobj_pot	sits_nsubj_cat	like_pobj_turtle
sits_nsubj_subway	at_pobj_station
laying_nsubj_mattress	on_pobj_floor	of_pobj_kitchen
near_pobj_hydrant	on_pobj_street
going_nsubj_train	through_pobj_area	by_pobj_lake
in_pobj_street	near_pobj_building
to_pobj_space	shining_nsubj_Light	in_pobj_window
in_pobj_park	of_pobj_doves
on_pobj_top
of_pobj_beer	to_pobj_bottles
between_pobj_apples
standing_nsubj_male	in_pobj_room	playing_dobj_Wii
has_nsubj_player	with_pobj_ball	outstretched_nsubj_arm	near_pobj_hand
is_nsubj_person	in_pobj_air	of_pobj_skis	on_pobj_pair
on_pobj_road	traveling_nsubj_Cars
showing_dobj_people	of_pobj_pictures
on_pobj_sides	of_pobj_people
over_pobj_jump	of_pobj_tire	of_pobj_halves	taking_dobj_horse
of_pobj_chairs	in_pobj_room
on_pobj_bed
of_pobj_crowd	in_pobj_front	performing_dobj_trick
on_pobj_surfboard	in_pobj_ocean
sitting_dobj_table	in_pobj_glass	with_pobj_glasses	of_pobj_food	with_pobj_plate
makes_dobj_way	through_pobj_area	makes_nsubj_train
featuring_dobj_Santas	playing_dobj_instruments
at_pobj_camera	pointing_dobj_finger	with_pobj_book
to_pobj_woman	in_pobj_building
of_pobj_court	on_pobj_top	serving_dobj_ball
of_pobj_computer	in_pobj_front	sits_nsubj_animal
cooking_nsubj_Food
to_pobj_opponent	serving_dobj_ball
in_pobj_park	on_pobj_skateboard
over_pobj_it	behind_pobj_log	hides_nsubj_bear
on_pobj_sidewalk	using_dobj_phone
on_pobj_cover	sits_nsubj_caps
has_nsubj_building	at_pobj_top	has_dobj_clocks	of_pobj_tower
with_pobj_racquet	playing_nsubj_woman	playing_dobj_tennis
taking_dobj_temperature	laying_nsubj_man	in_pobj_bed
smacks_nsubj_she	smacks_dobj_ball	looks_nsubj_woman
has_nsubj_kitchen	has_dobj_tile
of_pobj_pots	top_nsubj_stove	with_pobj_lots
with_pobj_ramp	going_nsubj_station
to_pobj_ad
rider_dobj_rails	during_pobj_event
in_pobj_grass	in_pobj_pants	holding_dobj_bat
besides_pobj_cake	on_pobj_dish	giving_dobj_thumbs	giving_dobj_sign
in_pobj_shelf
are_nsubj_people	at_pobj_bar	using_dobj_laptops
on_pobj_beach	of_pobj_people	on_pobj_horses
on_pobj_bench	sitting_nsubj_man
with_pobj_lights	on_pobj_phones	in_pobj_room
under_pobj_mother	stands_nsubj_elephant
taking_dobj_pictures	of_pobj_children
in_pobj_bathroom
of_pobj_toaster	ovens_nsubj_couple
on_pobj_surface	sitting_nsubj_bear
on_pobj_court
with_pobj_sustenance	on_pobj_table
with_pobj_computer
with_pobj_advertising
in_pobj_air	on_pobj_board
of_pobj_sun	of_pobj_water
at_pobj_table	of_pobj_children
covered_dobj_slope	riding_dobj_snow
on_pobj_grill	in_pobj_shirt
on_pobj_slice	on_pobj_plate	of_pobj_pizza
to_pobj_man	sitting_nsubj_who
to_pobj_pole
behind_pobj_umbrellas	stand_nsubj_people	facing_dobj_body	of_pobj_water
in_pobj_background	with_pobj_sign	on_pobj_road	sign_nsubj_stop
bringing_nsubj_player	bringing_dobj_ball	into_pobj_play
knees_nsubj_man	of_pobj_mountainside	of_pobj_snow	on_pobj_side
besides_pobj_pool	walking_nsubj_bear
in_pobj_ground	stands_nsubj_building	on_pobj_pole	near_pobj_trees	hand_nsubj_signs
has_nsubj_Someone	on_pobj_table	of_pobj_them	has_dobj_feet	in_pobj_front	with_pobj_television
on_pobj_twig	of_pobj_tree
carry_dobj_surfboards	carry_nsubj_people	through_pobj_ocean
holding_dobj_frisbees	in_pobj_field
to_pobj_meter
on_pobj_side	of_pobj_road
of_pobj_court	on_pobj_top	swinging_dobj_racquet

of_pobj_people	standing_nsubj_who
of_pobj_cars	on_pobj_street
stops_nsubj_trolley	board_nsubj_passengers	at_pobj_stop
through_pobj_door
down_pobj_grass	covered_dobj_hillside	walking_nsubj_bear
getting_nsubj_men	throw_dobj_freebie
along_pobj_bridge

on_pobj_slope	on_pobj_skis
during_pobj_event	on_pobj_field
in_pobj_park	of_pobj_signs	are_nsubj_light
at_pobj_something	of_pobj_interest	looking_nsubj_gentlemen	to_pobj_them
on_pobj_board	in_pobj_water
cut_nsubj_bride	cut_dobj_cake	look_nsubj_others
on_pobj_sidewalk	's_nsubj_it
down_pobj_runway	for_pobj_takeoff	taxis_nsubj_plane
waving_dobj_hands
with_pobj_background	of_pobj_sign
fielding_dobj_baseball	of_pobj_player
in_pobj_houses
near_pobj_people	in_pobj_plaza
in_pobj_plate	on_pobj_windowsill
in_pobj_jacket	on_pobj_slope	with_pobj_skis
holding_nsubj_People	to_pobj_traffic	holding_dobj_signs
in_pobj_front	with_pobj_beard	at_pobj_board	of_pobj_microphone
on_pobj_sidewalk
of_pobj_person	in_pobj_bed
with_pobj_banana
with_pobj_bananas
with_pobj_balcony
over_pobj_bowl
to_pobj_tree	in_pobj_planter
of_pobj_crowd	in_pobj_front	playing_dobj_baseball
to_pobj_train
standing_nsubj_people	on_pobj_street	to_pobj_motorcycles
headed_dobj_hill	in_pobj_California
with_pobj_computers	on_pobj_it
with_pobj_vegetables	with_pobj_pasta	on_pobj_plate
near_pobj_keyboard	on_pobj_desk
over_pobj_city
to_pobj_left	as_pobj_horse	pulled_nsubj_bicyclist
on_pobj_walk	of_pobj_people
behind_pobj_him	in_pobj_wetsuit	of_pobj_wave	in_pobj_barrel
between_pobj_trucks
drives_nsubj_airliner	shines_nsubj_sun	down_pobj_runway
with_pobj_sheets
flying_nsubj_man	flying_dobj_kite	at_pobj_beach
on_pobj_court	playing_dobj_tennis
of_pobj_picture	of_pobj_keyboard
has_dobj_snow	around_pobj_it
in_pobj_oven	on_pobj_plate
for_pobj_photographer	poses_nsubj_group	of_pobj_players
on_pobj_top	of_pobj_counter	inside_pobj_vase
doing_dobj_tricks	doing_nsubj_Skateboarders	as_pobj_crowd
with_pobj_food	on_pobj_table	on_pobj_plate
with_pobj_items	like_pobj_cups	on_pobj_it
with_pobj_urinals
with_pobj_tag	to_pobj_cow	on_pobj_ear
for_pobj_repairs	at_pobj_terminals	waiting_nsubj_airplanes
to_pobj_peel	Cleaned_dobj_apple
on_pobj_pole	with_pobj_camera
on_pobj_grass	of_pobj_sheep
standing_nsubj_lamb	on_pobj_grass
riding_dobj_seats	riding_nsubj_people
down_pobj_slope
on_pobj_desk	are_nsubj_monitors
with_pobj_desktop
at_pobj_top	with_pobj_clock	of_pobj_it
on_pobj_bench	in_pobj_outfit
containing_dobj_drink
on_pobj_phone	wearing_nsubj_woman
in_pobj_enclosure	with_pobj_ice
on_pobj_floor
facing_dobj_body	of_pobj_water	on_pobj_bench	sitting_nsubj_females	looking_dobj_direction
riding_dobj_bike	off_pobj_road
containing_dobj_items	over_pobj_shelf
in_pobj_hat	making_dobj_luch
eating_dobj_donut	in_pobj_restaurant
at_pobj_table	with_pobj_pizza	of_pobj_him	in_pobj_restaurant	in_pobj_front	has_dobj_toppings
of_pobj_zebras	with_pobj_trees	on_pobj_field	in_pobj_background
in_pobj_suit	down_pobj_slope
preparing_dobj_food	of_pobj_kitchen
in_pobj_sky	flying_nsubj_plane
on_pobj_pole	is_nsubj_it
on_pobj_sill	out_pobj_window	of_pobj_cat
sticking_dobj_head	in_pobj_trees
over_pobj_fence	in_pobj_grass	standing_nsubj_giraffe
throws_dobj_frisbee	throws_nsubj_woman	at_pobj_park
IN_pobj_MIRROR	IN_pobj_BATHROOM	OF_pobj_TOWEL
with_pobj_top
to_pobj_post	from_pobj_pair	with_pobj_clothing

watching_nsubj_players
holding_dobj_phone	to_pobj_child
on_pobj_skateboards	in_pobj_front	with_pobj_beagle
wearing_dobj_hat
of_pobj_people	on_pobj_bush
on_pobj_benches	of_pobj_people
in_pobj_air	with_pobj_suit	from_pobj_cliff
on_pobj_scene
in_pobj_breeze	atop_pobj_tower
in_pobj_jacket	in_pobj_snow
in_pobj_rain	walking_nsubj_umbrella
eating_dobj_grass	with_pobj_parents	in_pobj_field
near_pobj_tree	in_pobj_water
brush_dobj_teeth	with_pobj_toothbrush
with_pobj_Numerals
cutting_dobj_cake	at_pobj_wedding
holding_dobj_umbrella	wearing_dobj_mask	in_pobj_gear
down_pobj_side	on_pobj_board	standing_nsubj_Man
showing_dobj_rooms	of_pobj_photos
with_pobj_fence	with_pobj_sails	at_pobj_beach
beside_pobj_computer	is_nsubj_mouse
has_nsubj_building	has_dobj_writing	on_pobj_it
on_pobj_cabinets	of_pobj_microwave
to_pobj_motorcycle	on_pobj_stands	with_pobj_helmet
of_pobj_side	of_pobj_tree
on_pobj_court	playing_dobj_tennis	playing_nsubj_men
with_pobj_dog	wrestles_nsubj_person	over_pobj_frisbee
in_pobj_room
racing_nsubj_skier	racing_dobj_slopes
on_pobj_beach	of_pobj_people
goes_nsubj_sun	of_pobj_water
on_pobj_beach	playing_nsubj_people	with_pobj_kite
using_dobj_phone	take_dobj_picture	of_pobj_herself
climbing_nsubj_cat	in_pobj_it	with_pobj_plant	into_pobj_planter

in_pobj_room
on_pobj_top	facing_dobj_window	of_pobj_bed
sleeps_nsubj_cat	atop_pobj_control
goes_nsubj_woman	starts_nsubj_day	goes_dobj_surfing
sitting_nsubj_girl	on_pobj_bed	for_pobj_picture
of_pobj_store	in_pobj_window
holding_dobj_glass	smiles_nsubj_man
on_pobj_plate
on_pobj_wall
perched_nsubj_bird	on_pobj_top	in_pobj_forest	of_pobj_tree
with_pobj_vegetables	on_pobj_plate
split_nsubj_banana	with_pobj_topping
standing_nsubj_kid	on_pobj_skateboard
in_pobj_area
sitting_nsubj_pizza	on_pobj_stand
for_pobj_desert	reaching_nsubj_Hands	on_pobj_plate
through_pobj_air
appears_nsubj_what	sit_nsubj_woman	on_pobj_lot
on_pobj_plate	laying_nsubj_fork
with_pobj_people	in_pobj_front	of_pobj_taxi
to_pobj_wall
to_pobj_talk	of_pobj_people	at_pobj_party
swung_dobj_bat	swung_nsubj_he
of_pobj_soccer	playing_nsubj_man	playing_dobj_game	in_pobj_field
preparing_dobj_food	in_pobj_kitchen
wearing_dobj_gear	behind_pobj_him	to_pobj_racket
holding_dobj_pole	through_pobj_air	on_pobj_skis
of_pobj_wine
snowboarding_dobj_rail	snowboarding_nsubj_man
across_pobj_beach	to_pobj_ocean	walking_nsubj_couple	of_pobj_women
with_pobj_floor
instructing_dobj_children	play_dobj_tennis
through_pobj_side	of_pobj_crib	coming_nsubj_hand	of_pobj_baby
through_pobj_umbrellas
in_pobj_grass	by_pobj_water	flies_nsubj_girl	flies_dobj_kite
to_pobj_hydrant	on_pobj_street
wearing_dobj_tie
covered_nsubj_pizza	in_pobj_cheese
has_dobj_window	has_nsubj_room
on_pobj_log	in_pobj_water
to_pobj_cup	are_nsubj_donuts	on_pobj_paper
through_pobj_grass
in_pobj_street	with_pobj_umbrella
getting_dobj_food	of_pobj_people	getting_nsubj_group
at_pobj_night	on_pobj_street
on_pobj_court	is_nsubj_man
at_pobj_camera	on_pobj_window
to_pobj_alert	tuned_nsubj_television
into_pobj_air
with_pobj_boats	in_pobj_tide	washed_nsubj_harbor
in_pobj_cafe	beside_pobj_drink	of_pobj_dessert
in_pobj_area
with_pobj_mirror	behind_pobj_it	of_pobj_bird
riding_dobj_bike	up_pobj_side	of_pobj_mountain
at_pobj_table	with_pobj_laptop
showing_dobj_picture	on_pobj_phone
pulled_nsubj_man	with_pobj_sunglasses	to_pobj_head	from_pobj_glass
painting_nsubj_who	painting_dobj_designs	on_pobj_vase
ON_pobj_RAILS	IS_nsubj_TRAIN
takes_nsubj_area	of_pobj_street	takes_dobj_part
inside_pobj_stalls	under_pobj_tent
on_pobj_diamond	holding_nsubj_player	holding_dobj_bat
photoshopped_nsubj_child	over_pobj_image	on_pobj_skateboard
WITH_pobj_SYMBOLS	ON_pobj_IT
in_pobj_bunches	on_pobj_tree
has_dobj_pattern	on_pobj_floor	with_pobj_cabinets	has_nsubj_bathroom
on_pobj_table	on_pobj_plate
of_pobj_concrete	sniffs_dobj_piece	leans_nsubj_dog
on_pobj_pole	hanging_nsubj_sign
tops_nsubj_egg	with_pobj_cheese	with_pobj_yolk	tops_dobj_pizza
cabinets_dobj_oven	cabinets_nsubj_refrigerator	cabinets_dobj_stove
onto_pobj_street	turning_nsubj_bus
on_pobj_course
with_pobj_beds
in_pobj_rain	with_pobj_umbrellas	walking_nsubj_females
on_pobj_shore	of_pobj_beach
with_pobj_poles
holding_dobj_phone	in_pobj_hand
has_dobj_panels	with_pobj_image	of_pobj_Monroe	has_nsubj_umbrella
watch_nsubj_group	of_pobj_stairs	of_pobj_people	down_pobj_rail	riding_dobj_skateboard
tossing_dobj_frisbee	in_pobj_field
with_pobj_seeds	topped_nsubj_fry	of_pobj_mushrooms	in_pobj_wok
of_pobj_women	at_pobj_table	with_pobj_laptop	to_pobj_group
atop_pobj_heater	looking_dobj_windowpane
sitting_nsubj_bear

has_nsubj_floor	is_nsubj_sink	has_dobj_pattern	of_pobj_tiles
by_pobj_side	on_pobj_floor	of_pobj_side
with_pobj_bat	in_pobj_hands
shows_nsubj_photo	shows_dobj_airplane
near_pobj_building	on_pobj_tower
on_pobj_floor	sitting_nsubj_umbrellas	in_pobj_room
to_pobj_control	on_pobj_top	of_pobj_couch
on_pobj_ramp	doing_dobj_trick	on_pobj_skateboard
drink_nsubj_kittens	drink_dobj_water	from_pobj_bowls
standing_nsubj_elephant	made_dobj_pond	beside_pobj_man
with_pobj_people
around_pobj_lake	in_pobj_boats

around_pobj_habitat
walking_nsubj_pedestrian	of_pobj_highway	by_pobj_bus	down_pobj_side
across_pobj_street
PLAYING_dobj_TENNIS	ON_pobj_COURT
near_pobj_bridge	with_pobj_background
sitting_nsubj_mouse	from_pobj_computer	on_pobj_pad
of_pobj_elephants	in_pobj_dirt
in_pobj_lot
from_pobj_women	running_nsubj_dogs	on_pobj_bench
at_pobj_reflection	in_pobj_mirror
with_pobj_graphics	on_pobj_inside
on_pobj_land	of_pobj_water	near_pobj_body	behind_pobj_it	eating_dobj_grass
blinding_dobj_player	seems_nsubj_sun
throwing_dobj_disk	in_pobj_field
in_pobj_car	of_pobj_window
petting_dobj_giraffe	by_pobj_fence	standing_nsubj_woman
says_dobj_Center	with_pobj_clock	says_nsubj_it
in_pobj_dress	in_pobj_woman	give_dobj_look
at_pobj_desks
in_pobj_icicles	frozen_nsubj_hydrant
on_pobj_court	standing_nsubj_children
covered_dobj_benches	to_pobj_snow	covered_nsubj_directory
playing_dobj_tennis	for_pobj_crowd
holding_dobj_controller	holding_nsubj_person
reading_dobj_end
for_pobj_sale	in_pobj_market	are_nsubj_Pineapples
with_pobj_remotes	in_pobj_rooms
in_pobj_restaurant	on_pobj_device
of_pobj_salad	of_pobj_pasta	sits_nsubj_bowl	to_pobj_glass
of_pobj_building	in_pobj_front	on_pobj_motorcycles
is_nsubj_Pizza	on_pobj_board	around_pobj_it	with_pobj_settings
with_pobj_vegetables	on_pobj_it
on_pobj_lot
in_pobj_cabin
with_pobj_walls
sitting_nsubj_microwave	in_pobj_kitchen
are_nsubj_man
check_dobj_condition	wait_nsubj_associates	looking_nsubj_students	at_pobj_monitor	in_pobj_anticipation
in_pobj_front	with_pobj_floor	of_pobj_refridgerator
of_pobj_horses	down_pobj_beach
throw_dobj_ball	is_nsubj_man
in_pobj_setting
on_pobj_table	on_pobj_pan
takes_dobj_photo	takes_nsubj_man	in_pobj_bunk
to_pobj_donut	on_pobj_table	of_pobj_coffee
with_pobj_side	on_pobj_plate	of_pobj_sauce
on_pobj_snow	of_pobj_skiers
on_pobj_bench	overlooking_dobj_water	sitting_nsubj_people
on_pobj_bench
in_pobj_boat	wearing_dobj_jacket
with_pobj_chair
with_pobj_car	travel_dobj_street	travel_nsubj_Horses
to_pobj_motorcycles	of_pobj_men
throwing_dobj_pitch	playing_dobj_baseball
on_pobj_mountain	jumping_dobj_hill
in_pobj_water	on_pobj_bicycle	passes_dobj_sailboat	passes_nsubj_person
on_pobj_plate	of_pobj_pizza	with_pobj_knives
running_nsubj_man	from_pobj_water	along_pobj_shoreline	watches_nsubj_person
sitting_nsubj_vehicle	on_pobj_street
grazing_nsubj_zebras	in_pobj_field
watching_dobj_them	watching_nsubj_horses
with_pobj_glass	of_pobj_milk	sandwich_nsubj_peanut
of_pobj_pizza	on_pobj_them
in_pobj_front	shows_dobj_yard	of_pobj_window
to_pobj_desk	with_pobj_computer	on_pobj_it
are_nsubj_cows	in_pobj_field
with_pobj_stripe	down_pobj_nose	in_pobj_field
from_pobj_box	in_pobj_kitchen	eating_dobj_pizza
flying_dobj_kites	of_pobj_people	flying_nsubj_group

of_pobj_train
standing_nsubj_dog	of_pobj_bike	on_pobj_back
of_pobj_food	with_pobj_sandwich	of_pobj_plate
through_pobj_field	of_pobj_grass
stares_nsubj_giraffe	at_pobj_tree
with_pobj_pot	on_pobj_top
of_pobj_people	board_dobj_jet
sitting_nsubj_dog	to_pobj_feet
on_pobj_top	of_pobj_board
holding_dobj_bride	in_pobj_arms	holding_nsubj_groom
in_pobj_surf	walking_nsubj_woman
's_nsubj_bus	's_nsubj_it	on_pobj_street	to_pobj_bus
over_pobj_hill	of_pobj_kites	in_pobj_colors
kicking_nsubj_girl	kicking_dobj_ball	in_pobj_stadium	in_pobj_shorts
from_pobj_market
of_pobj_vase
of_pobj_area
to_pobj_plate	holding_nsubj_player	holding_dobj_bat
on_pobj_top	near_pobj_building	of_pobj_snow	sitting_nsubj_train
with_pobj_monitor	at_pobj_desk
at_pobj_skatepark	giving_dobj_thumbs
of_pobj_son	with_pobj_lots
on_pobj_motorcycle
of_pobj_suitcases	ride_nsubj_number	on_pobj_belt
in_pobj_background	on_pobj_top	with_pobj_trees	of_pobj_elephant
in_pobj_rain	of_pobj_street	on_pobj_side
performing_nsubj_men	in_pobj_costumes
of_pobj_cars	by_pobj_row	of_pobj_buildings
catch_dobj_ball	misses_nsubj_batter	prepares_nsubj_catcher
of_pobj_animals	near_pobj_forest

near_pobj_light	of_pobj_sign
's_nsubj_it	with_pobj_frisbee
in_pobj_field	of_pobj_zebras	are_nsubj_couple
in_pobj_lot	in_pobj_foreground
with_pobj_waffles	in_pobj_apples	with_pobj_sugar
in_pobj_front	of_pobj_apples	of_pobj_batch
reaches_nsubj_player	with_pobj_racket
covered_dobj_trees	covered_nsubj_man	skiing_dobj_slope
on_pobj_bench	sitting_nsubj_cat
using_dobj_holder	with_pobj_phone	with_pobj_clip	to_pobj_it	of_pobj_desk
on_pobj_way	near_pobj_flowers
during_pobj_trick	is_nsubj_skateboarder
on_pobj_pavement	jumps_nsubj_man	skates_nsubj_he
preparing_dobj_food	in_pobj_kitchen
of_pobj_deck	of_pobj_wear	shows_dobj_lots	shows_nsubj_bottom
consists_nsubj_meal	of_pobj_beef
with_pobj_toilets
cross_dobj_country	across_pobj_trail	cross_nsubj_people
in_pobj_middle	of_pobj_intersection
along_pobj_side	of_pobj_road
on_pobj_top	riding_dobj_skateboard	of_pobj_sign
on_pobj_court	holds_nsubj_man	holds_dobj_racket
in_pobj_sink	in_pobj_room
with_pobj_corner	of_pobj_quilt	turned_nsubj_lays
with_pobj_grass	sits_nsubj_bench	in_pobj_concrete
towards_pobj_bull	on_pobj_horse
of_pobj_donuts	with_pobj_eyeglasses	on_pobj_table	having_dobj_plate
swinging_nsubj_who	at_pobj_pitch	at_pobj_game
with_pobj_tops
from_pobj_chair	looking_nsubj_cat
with_pobj_floor	with_pobj_mirror
of_pobj_elephants	to_pobj_herd	tending_nsubj_boy	in_pobj_enclosure
covered_dobj_ground	on_pobj_snow	on_pobj_skis	of_pobj_people

of_pobj_airplane	on_pobj_tarmac
riding_dobj_skateboard	up_pobj_side	of_pobj_ramp
snuggling_nsubj_cat	with_pobj_bear
on_pobj_top	with_pobj_sign	sign_nsubj_stop
of_pobj_branch	perched_nsubj_bird	on_pobj_top
walk_nsubj_surfers	holding_dobj_boards	down_pobj_beach
in_pobj_middle	of_pobj_pipe
are_nsubj_box	of_pobj_liquor	on_pobj_table	of_pobj_Cola	of_pobj_doughnuts
carrying_dobj_surfboard	wearing_dobj_suite	into_pobj_ocean
inside_pobj_box	with_pobj_head	smelling_dobj_food
with_pobj_sink	inside_pobj_bathroom	taking_dobj_picture
has_nsubj_baby	in_pobj_mouth	has_dobj_brush
on_pobj_snowboard	waits_nsubj_one	getting_nsubj_man
is_nsubj_bus	on_pobj_road
on_pobj_street
in_pobj_kitchen	near_pobj_it	with_pobj_others
with_pobj_pile	of_pobj_foods	topped_nsubj_plate
lived_nsubj_woman	in_pobj_kitchen
on_pobj_field	holding_dobj_bat	to_pobj_ball
at_pobj_table	of_pobj_people	eating_dobj_food
of_pobj_truck	trim_nsubj_chrome
of_pobj_city	in_pobj_crosswalk	with_pobj_pedestrians
posing_nsubj_man	in_pobj_shirt
into_pobj_blanket	tucked_nsubj_bear
of_pobj_pizza	on_pobj_spoon
like_pobj_control	with_pobj_hair	in_pobj_instrument
over_pobj_jump	on_pobj_slope	goes_nsubj_skier
taking_nsubj_woman	taking_dobj_photograph	in_pobj_mirror
around_pobj_toilet	has_dobj_accessories	has_nsubj_bathroom
pays_nsubj_dog	to_pobj_something	of_pobj_frame	pays_dobj_attention
with_pobj_fence	provide_dobj_screen
of_pobj_family	at_pobj_store	taking_dobj_picture
swinging_nsubj_player	tries_nsubj_catcher	at_pobj_ball	catch_dobj_it	swinging_dobj_bat
of_pobj_house	looking_dobj_window
facing_dobj_television	on_pobj_recliner	in_pobj_room	sitting_nsubj_Cat
in_pobj_air	on_pobj_skateboard
of_pobj_bathroom	on_pobj_toilet	sitting_nsubj_cats
closed_nsubj_baby	on_pobj_bed	with_pobj_eyes
to_pobj_woman	wearing_dobj_suit
around_pobj_her	at_pobj_table	with_pobj_plates	of_pobj_food
in_pobj_preserve	on_pobj_road	stand_nsubj_zebras
with_pobj_carrier	in_pobj_round
at_pobj_night	on_pobj_road
in_pobj_sink	of_pobj_cat
like_pobj_structure	on_pobj_it	of_pobj_warehouse	with_pobj_numerals	has_dobj_clock	from_pobj_ceiling
OF_pobj_SOUP	IN_pobj_SHAPE	ON_pobj_STREET
holding_dobj_dog
near_pobj_buggy	standing_nsubj_People
doing_dobj_something	by_pobj_itself	doing_nsubj_person
in_pobj_front	of_pobj_desk
on_pobj_surfboard	riding_dobj_wave
from_pobj_runway
pulls_dobj_wrapping	pulls_nsubj_Guy	wrapping_dobj_tv
on_pobj_bed	reads_dobj_book	sits_nsubj_cat
of_pobj_arena
in_pobj_park	with_pobj_crowd	watchin_dobj_him	watchin_nsubj_man
of_pobj_motorcycles	on_pobj_street
by_pobj_spatula
towards_pobj_batter	pitching_dobj_ball
in_pobj_lot	with_pobj_workers
of_pobj_cheesecake	with_pobj_fork	on_pobj_plate
returns_dobj_ball	using_dobj_racquet	returns_nsubj_man
running_nsubj_children	on_pobj_teams	toward_pobj_ball
through_pobj_snow	on_pobj_board	jumping_nsubj_snowboarder
with_pobj_sink	of_pobj_dishes
in_pobj_room	painting_dobj_pot
is_nsubj_player	serve_nsubj_her
riding_nsubj_person	riding_dobj_ski	in_pobj_water
with_pobj_tower
drawn_dobj_carriage	by_pobj_curb	is_nsubj_horse
with_pobj_design	at_pobj_top
from_pobj_mother
stopped_nsubj_people
for_pobj_singin	in_pobj_rain	with_pobj_ad	on_pobj_side
with_pobj_cakes
in_pobj_air	of_pobj_skateboarder	taking_dobj_picture	taking_nsubj_person
of_pobj_street	on_pobj_side	on_pobj_bucket
by_pobj_barrow	on_pobj_grass
in_pobj_swamp	on_pobj_stump
on_pobj_bench	with_pobj_collar
to_pobj_bunch
of_pobj_projection	in_pobj_front	of_pobj_music	stands_nsubj_man
sits_nsubj_cat	flies_nsubj_bird	on_pobj_pavement
sitting_nsubj_table	outside_pobj_kitchen
on_pobj_cake	blowing_dobj_candles
into_pobj_fourths	on_pobj_plate
on_pobj_court
stears_nsubj_man	through_pobj_water
's_nsubj_it	with_pobj_word
of_pobj_field	of_pobj_giraffe	on_pobj_top
in_pobj_park	with_pobj_everything
laptop_nsubj_person
parked_nsubj_jetliner	at_pobj_airport
flies_nsubj_plane	in_pobj_sky
using_dobj_computer	show_dobj_boy	show_nsubj_images
on_pobj_sidewalk	is_nsubj_hydrant
on_pobj_desktop	is_nsubj_program
has_dobj_toilet	to_pobj_wall	mounted_nsubj_bathroom
handles_dobj_pizza	handles_nsubj_girl	out_pobj_oven
of_pobj_doughnuts	in_pobj_box
getting_nsubj_people	onto_pobj_bus
for_pobj_birthday	shaped_nsubj_cake	like_pobj_sheep
of_pobj_man	in_pobj_front	of_pobj_truck	with_pobj_umbrella
on_pobj_ground	near_pobj_skateboard	lies_nsubj_person
by_pobj_stall	in_pobj_field
on_pobj_day	of_pobj_tower
by_pobj_leash	with_pobj_bag
holding_dobj_baby	on_pobj_computer	playing_nsubj_man
has_nsubj_building	has_dobj_clock	of_pobj_it	on_pobj_side
under_pobj_sky	over_pobj_ocean	riding_dobj_kiteboard
of_pobj_noodles
in_pobj_wetsuit	in_pobj_ocean	on_pobj_surfboard
on_pobj_wall
in_pobj_case
with_pobj_cabinets	tiled_dobj_floor
on_pobj_ground	walking_nsubj_zebras	in_pobj_corral
in_pobj_dark	on_pobj_street
mounted_dobj_urinals	over_pobj_floor	mounted_nsubj_couple	of_pobj_wall
in_pobj_store	with_pobj_varieties	of_pobj_foodstuffs
in_pobj_water
on_pobj_cobblestones	near_pobj_truck
in_pobj_restroom
by_pobj_side	of_pobj_road
leaves_nsubj_plane	doing_dobj_inspection
on_pobj_table
with_pobj_food	to_pobj_plate	on_pobj_table	on_pobj_it
on_pobj_top	of_pobj_bed	of_pobj_woman
of_pobj_people	passing_nsubj_scene	on_pobj_motorcycle	passing_dobj_pedestrian
in_pobj_water	flying_dobj_kite	are_nsubj_people	flying_nsubj_man	at_pobj_beach
inside_pobj_boxes	with_pobj_orders	of_pobj_sauce
of_pobj_bed	is_nsubj_television	at_pobj_end

to_pobj_van	driving_dobj_road	on_pobj_motorcycle
throwing_dobj_frisbee	to_pobj_man	in_pobj_yard	with_pobj_tatoo
of_pobj_field	of_pobj_zebras	under_pobj_tree	in_pobj_middle
of_pobj_people	around_pobj_airplane
in_pobj_suit	down_pobj_slope
holding_dobj_phone	to_pobj_child
perched_nsubj_bird	in_pobj_woods	on_pobj_sick
on_pobj_car
in_pobj_foreground	with_pobj_tower	above_pobj_them	of_pobj_picture	are_nsubj_trees
on_pobj_field	with_pobj_tusk
of_pobj_case	is_nsubj_child
on_pobj_surfboard	of_pobj_people
at_pobj_restaurant	on_pobj_table
in_pobj_background	of_pobj_sprinkler	with_pobj_man
in_pobj_field
stands_nsubj_church	with_pobj_clock	behind_pobj_fence
in_pobj_field
in_pobj_area	with_pobj_leaves
flying_dobj_kite	in_pobj_field
do_dobj_trick	tries_nsubj_kid
in_pobj_lot	of_pobj_trucks
in_pobj_front	of_pobj_TV
at_pobj_ball
of_pobj_water	of_pobj_pond	on_pobj_side
tries_nsubj_girl	fly_dobj_it	holding_dobj_kite
including_pobj_wig	of_pobj_items
on_pobj_keyboard	resting_nsubj_cat
playing_nsubj_woman	playing_dobj_tennis	in_pobj_shirt
in_pobj_hat	riding_dobj_horse
around_pobj_sidewalk	of_pobj_men
with_pobj_boombox	in_pobj_corner	on_pobj_it
with_pobj_laptop	on_pobj_floor
on_pobj_table	make_dobj_drink
from_pobj_trees	eating_dobj_leaves
into_pobj_food	with_pobj_utensils
on_pobj_top	of_pobj_bench
sits_nsubj_bird	on_pobj_tree
of_pobj_boardwalk	with_pobj_tables	by_pobj_umbrellas
of_pobj_sandwich	on_pobj_it	has_dobj_kind
are_nsubj_line	of_pobj_ovens	in_pobj_kitchen	on_pobj_wall
poses_nsubj_woman	outside_pobj_bus	for_pobj_picture
to_pobj_cart	with_pobj_boxes	waiting_nsubj_People
cutting_dobj_line	cutting_nsubj_man	on_pobj_boat
ON_pobj_HER	IS_nsubj_WOMAN	WITH_pobj_HELEMT
sink_nsubj_kitchen	with_pobj_refrigerator
in_pobj_bowls	of_pobj_foods	on_pobj_table
of_pobj_bed	by_pobj_sun	on_pobj_end	though_pobj_window	with_pobj_seats
riding_dobj_bikes	of_pobj_people
in_pobj_bowls	with_pobj_foods
kettle_dobj_cup
in_pobj_holding	holding_dobj_toothbrush
of_pobj_grasses	standing_nsubj_zebras	in_pobj_field
threw_dobj_course	riding_nsubj_woman	riding_dobj_horse
from_pobj_it	of_pobj_signs	with_pobj_lots
of_pobj_boots	of_pobj_car	of_pobj_bags	is_nsubj_back
of_pobj_roof
on_pobj_top	of_pobj_people	of_pobj_surfboards
with_pobj_curtains
hit_dobj_pitch	prepares_nsubj_batter
of_pobj_ramen	of_pobj_scissors	to_pobj_package
to_pobj_water	with_pobj_balloons
clock_nsubj_holder
perform_dobj_functions	perform_nsubj_it	with_pobj_pad
playing_nsubj_ladies	playing_dobj_game	watch_nsubj_people	of_pobj_tennis
riding_dobj_skateboard	down_pobj_road
in_pobj_hat	near_pobj_bench	jumping_nsubj_skateboarder

at_pobj_restaurant	of_pobj_food	on_pobj_table
on_pobj_rail	of_pobj_bowl	eating_nsubj_cat
of_pobj_sandwich	of_pobj_food
above_pobj_entrance
with_pobj_clock	on_pobj_it
with_pobj_background	flying_dobj_kite
for_pobj_pitch	at_pobj_plate	waiting_nsubj_batter
in_pobj_jacket	holding_dobj_umbrella	holding_nsubj_woman
climb_dobj_mountain	struggling_nsubj_man
sits_nsubj_glass	of_pobj_wine	to_pobj_bottle
is_nsubj_pizza	with_pobj_fork	to_pobj_it	on_pobj_plate
performing_dobj_trick	on_pobj_skateboard
of_pobj_truck	in_pobj_line	at_pobj_sheep	to_pobj_back	look_nsubj_People
holding_dobj_umbrella	on_pobj_area
riding_dobj_skateboard	down_pobj_lot
sitting_nsubj_person	under_pobj_umbrella
of_pobj_people	at_pobj_beach
with_pobj_sign	in_pobj_room
in_pobj_grass	near_pobj_tracks
with_pobj_contents	of_pobj_purse
at_pobj_top	of_pobj_mountain
in_pobj_enclosure	getting_dobj_attention	from_pobj_cows
in_pobj_space
skiing_dobj_slopes	skiing_nsubj_man
down_pobj_street	of_pobj_motorcycle	on_pobj_back
flying_nsubj_people	of_pobj_grass	flying_dobj_kites	in_pobj_field
takes_dobj_sip	takes_nsubj_woman	from_pobj_glass
on_pobj_bed	are_nsubj_animals
of_pobj_pizza	holding_dobj_plates	holding_nsubj_Someone
of_pobj_bicycle	cleaning_dobj_parts
on_pobj_ground	playing_dobj_frisbee
near_pobj_shoreline	with_pobj_board	under_pobj_arm
in_pobj_backyard	on_pobj_table
in_pobj_sand	gathering_nsubj_birds	near_pobj_water
over_pobj_steps	through_pobj_air
by_pobj_rocks	in_pobj_time
painted_nsubj_head	on_pobj_it	sign_nsubj_stop
on_pobj_tracks	sit_nsubj_cars
on_pobj_surfboard	crashing_dobj_waves
on_pobj_bench
on_pobj_bench
of_pobj_design	holds_nsubj_vase	beside_pobj_chair	in_pobj_front	of_pobj_flowers	holds_dobj_bouquet	behind_pobj_rail
at_pobj_station	on_pobj_track
hits_dobj_ball	hits_nsubj_racket
in_pobj_bathroom
with_pobj_tag	sits_nsubj_chihuahua	in_pobj_display
towards_pobj_frisbee	on_pobj_grass
is_nsubj_crib	under_pobj_television	in_pobj_room
around_pobj_courtyard	of_pobj_enclosure
grazing_nsubj_zebras	near_pobj_hills	in_pobj_field
of_pobj_vegtables	put_nsubj_lot	into_pobj_crates
to_pobj_kid	holding_dobj_umbrella	wearing_dobj_raincoat	standing_nsubj_woman
on_pobj_cake	at_pobj_candle
to_pobj_tree	walking_nsubj_giraffe
on_pobj_ground	sit_nsubj_figurines	near_pobj_fence
of_pobj_cake	with_pobj_fork	on_pobj_plate
with_pobj_food	with_pobj_plates	near_pobj_plates
on_pobj_ground	flying_dobj_kite	lying_nsubj_person
on_pobj_edge	flies_dobj_kite	of_pobj_cliff	flies_nsubj_person	stands_nsubj_person
near_pobj_plate	of_pobj_food	with_pobj_head
riding_dobj_skateboard	up_pobj_side	of_pobj_ramp
over_pobj_edge	of_pobj_counter	on_pobj_it	with_pobj_electronics	hang_nsubj_wires
laying_nsubj_Cat	on_pobj_top	on_pobj_leash	of_pobj_dog
in_pobj_lot
taking_dobj_swing	at_pobj_ball
wrapping_dobj_silverware	wrapping_nsubj_group	of_pobj_people	from_pobj_baskets
with_pobj_people
driving_dobj_truck	with_pobj_dog	beside_pobj_him
with_pobj_fruit

holding_dobj_clipboard	sing_nsubj_man	sing_dobj_cellphone
of_pobj_keyboards	on_pobj_table	in_pobj_front	sitting_nsubj_row	of_pobj_monitors
on_pobj_vegetation
with_pobj_flowers	on_pobj_it	by_pobj_window
of_pobj_boxes	on_pobj_motorcycle	with_pobj_load
around_pobj_table	of_pobj_people
during_pobj_day	in_pobj_ocean	surfing_nsubj_surfer
of_pobj_wildflowers	on_pobj_table
in_pobj_it	with_pobj_suds
on_pobj_water	near_pobj_beach
with_pobj_bedroom	set_nsubj_bedroom
of_pobj_tee	hits_dobj_ball	hits_nsubj_child
standing_nsubj_people	by_pobj_stand
on_pobj_tarmac	on_pobj_day
for_pobj_photo
performing_dobj_trick	on_pobj_skateboard
flies_nsubj_plane	in_pobj_sky	of_pobj_wing
of_pobj_street	along_pobj_side
tethered_nsubj_Cow	eating_dobj_hay	eating_nsubj_chain	in_pobj_field
striking_nsubj_woman	striking_dobj_ball
at_pobj_animals	of_pobj_tourists
in_pobj_attire	with_pobj_tie
within_pobj_dome	with_pobj_clock	near_pobj_top
with_pobj_section	on_pobj_side
on_pobj_surfboard	riding_dobj_wave
in_pobj_ocean
wearing_dobj_coat	stands_nsubj_woman	near_pobj_sheep	behind_pobj_fence
of_pobj_pole	on_pobj_top	sign_nsubj_stop
on_pobj_field	playing_dobj_frisbee
in_pobj_area	in_pobj_wear	of_pobj_people
of_pobj_tent
during_pobj_game	in_pobj_swing
with_pobj_window
to_pobj_youth	stands_nsubj_man
in_pobj_background	with_pobj_protrusions	in_pobj_water	at_pobj_beach
of_pobj_colors	of_pobj_sheep
to_pobj_it	in_pobj_room	with_pobj_stand
with_pobj_room	of_pobj_house
include_nsubj_herd	include_dobj_adults	of_pobj_elephants
at_pobj_stop
traveling_nsubj_bunch	of_pobj_bicyclists	down_pobj_road
around_pobj_elephant	of_pobj_people
is_nsubj_player	in_pobj_game
into_pobj_piece	in_pobj_background	of_pobj_scissors	of_pobj_fabric	with_pobj_items
of_pobj_tourists	at_pobj_gathering	shows_dobj_phone	shows_nsubj_woman
in_pobj_mirror	of_pobj_woman
on_pobj_floor	with_pobj_knees	on_pobj_mattress
in_pobj_front	with_pobj_dog	of_pobj_fountain
in_pobj_water	by_pobj_fence	walking_nsubj_elephant
of_pobj_booths	in_pobj_front	lay_nsubj_boards	on_pobj_sand

playing_dobj_Nintendo	in_pobj_shirt
observing_nsubj_dog	for_pobj_it	observing_dobj_cake
wearing_dobj_tie
on_pobj_skiis	of_pobj_person	going_dobj_slope
in_pobj_distance	of_pobj_people	watching_dobj_pass	on_pobj_bench	sit_nsubj_pair
in_pobj_bathroom
with_pobj_dogs	holding_dobj_mills	near_pobj_road
eating_dobj_grass	eating_nsubj_horses	in_pobj_field
with_pobj_screens

in_pobj_median	by_pobj_mums
with_pobj_beans	of_pobj_soup
sink_nsubj_bathroom
at_pobj_table	of_pobj_pizza	with_pobj_plate
on_pobj_top	cut_dobj_cards
of_pobj_paper	of_pobj_image
calmed_nsubj_sign	calmed_dobj_neighborhood	reads_dobj_traffic
in_pobj_front	talks_nsubj_woman	of_pobj_slide	on_pobj_phone
under_pobj_sky	in_pobj_field
playing_dobj_soccer	on_pobj_field	with_pobj_parents
with_pobj_buildings
by_pobj_car	in_pobj_grass

on_pobj_court	with_pobj_racquet
driving_dobj_tracks	in_pobj_city
with_pobj_shower
carrying_dobj_skateboards	of_pobj_people	into_pobj_park	of_pobj_them
spiting_dobj_something	in_pobj_toilet
with_pobj_sink	in_pobj_it
to_pobj_cup	of_pobj_coffee	of_pobj_doughnuts
at_pobj_camera	on_pobj_chair	from_pobj_perch	under_pobj_table	with_pobj_stares
of_pobj_truck	in_pobj_back
with_pobj_signs	on_pobj_corner
on_pobj_field	of_pobj_sheep
laughs_nsubj_woman	thumbing_dobj_phone
in_pobj_pen	looking_nsubj_giraffe	over_pobj_fence
in_pobj_group
of_pobj_bread	with_pobj_bird	eating_dobj_it
of_pobj_sheep	because_pobj_herd	on_pobj_road
doing_dobj_things	of_pobj_people	in_pobj_pictures
of_pobj_cars	with_pobj_streetlight
to_pobj_fence	holding_dobj_frisbee	with_pobj_hoodie
in_pobj_house	lies_nsubj_remains	of_pobj_washroom
with_pobj_pole
on_pobj_bench	gazing_nsubj_Man
of_pobj_scaffolding	by_pobj_lots
of_pobj_water	of_pobj_coffee
laying_nsubj_cat	on_pobj_chair
to_pobj_half	sliced_nsubj_apple	of_pobj_apple
in_pobj_factory	on_pobj_head	with_pobj_towel	making_dobj_cigars
in_pobj_kitchen	by_pobj_microwave
of_pobj_shoulder	riding_dobj_horse
of_pobj_scissors	in_pobj_front	with_pobj_pair	of_pobj_face
at_pobj_something	sitting_nsubj_woman	on_pobj_phone
of_pobj_birds	above_pobj_beach	flying_nsubj_group
with_pobj_plants
herding_dobj_sheep	down_pobj_road
on_pobj_table	in_pobj_room
on_pobj_ground	on_pobj_field	stand_nsubj_airplane
are_nsubj_people	on_pobj_frisbee
have_nsubj_plates	of_pobj_them	have_dobj_meal
in_pobj_field
behind_pobj_fence	in_pobj_dirt
in_pobj_area	eating_dobj_grasses
by_pobj_side	sit_nsubj_halves	of_pobj_panini	on_pobj_plate
in_pobj_park	with_pobj_people	on_pobj_it
matching_dobj_freezer
playing_dobj_soccer	on_pobj_field	of_pobj_men
in_pobj_field
with_pobj_boar
in_pobj_lot	with_pobj_bag
with_pobj_pack
of_pobj_sink	sitting_nsubj_cat	on_pobj_corner
have_dobj_blankets	on_pobj_them

smiling_nsubj_man	with_pobj_shirt
of_pobj_shore	stands_nsubj_crane	on_pobj_edge
in_pobj_side
with_pobj_arms	at_pobj_desk	working_nsubj_woman
to_pobj_boy
sits_nsubj_woman	at_pobj_desk
on_pobj_sidewalk	of_pobj_skateboarders	riding_dobj_skateboards
using_dobj_computer
on_pobj_motorcycle	is_nsubj_guy
on_pobj_top	near_pobj_post	of_pobj_cover
with_pobj_frisbee	doing_dobj_trick
of_pobj_bathroom
to_pobj_buildings
with_pobj_vegetables	on_pobj_it
in_pobj_grass	on_pobj_day
of_pobj_man	against_pobj_wall
with_pobj_computer	on_pobj_top	of_pobj_it
past_pobj_trees
on_pobj_rug
striking_dobj_ball	with_pobj_batter	striking_nsubj_players
to_pobj_meter	on_pobj_street
across_pobj_bathroom	over_pobj_tub	hanging_nsubj_feet
is_nsubj_train	near_pobj_sign	on_pobj_track
trying_nsubj_person	with_pobj_racket	hit_dobj_ball
of_pobj_fabric	with_pobj_scissors	cutting_dobj_piece
at_pobj_computer	stands_nsubj_man	on_pobj_chair
on_pobj_court
catch_dobj_Frisbee	in_pobj_air	jumping_nsubj_who
on_pobj_sidewalk	on_pobj_bicycle	to_pobj_truck
for_pobj_picture	posing_nsubj_group	of_pobj_bikers
by_pobj_gates
in_pobj_area	in_pobj_front	playing_dobj_frisbee	of_pobj_tents
on_pobj_snowboards	in_pobj_snow	of_pobj_kids
on_pobj_court
of_pobj_sink	through_pobj_mirror	taking_dobj_picture
with_pobj_dishes	on_pobj_top	of_pobj_it
of_pobj_field	in_pobj_middle	holding_nsubj_baby	holding_dobj_poles
of_pobj_dogs
in_pobj_decor
at_pobj_district
of_pobj_beds	in_pobj_house
in_pobj_grass	of_pobj_cows
at_pobj_plate
on_pobj_water	with_pobj_trees	in_pobj_background
around_pobj_motorcycle	gathered_nsubj_group	of_pobj_people
riding_dobj_skateboard	through_pobj_air
on_pobj_skateboard
on_pobj_top	of_pobj_bed
with_pobj_paintings	on_pobj_ceiling	on_pobj_wall
with_pobj_food	stand_nsubj_people	around_pobj_kitchen
sits_nsubj_woman	in_pobj_jacket	astride_pobj_horse
flying_dobj_kits	with_pobj_monument
on_pobj_bed	with_pobj_bear
above_pobj_toilet	of_pobj_bathroom	with_pobj_plant	near_pobj_sink	of_pobj_city
over_pobj_giraffes
holds_nsubj_dog	on_pobj_street	holds_dobj_paw
of_pobj_bus	on_pobj_side
on_pobj_beach	to_pobj_ocean	of_pobj_people
in_pobj_field
IN_pobj_RAIN
chained_nsubj_dog	to_pobj_bike	to_pobj_pole
of_pobj_door	in_pobj_front	to_pobj_house
with_pobj_bicycle	with_pobj_hat
on_pobj_surfboard	ridding_dobj_wave
on_pobj_surfboard	in_pobj_ocean
in_pobj_bloom	of_pobj_floret
texting_nsubj_female	on_pobj_phone
climbing_dobj_stairs	into_pobj_airplane
in_pobj_background	doing_dobj_trick
on_pobj_motorbikes	on_pobj_road	of_pobj_people	ride_nsubj_group
in_pobj_ways	of_pobj_carrots
of_pobj_cars	of_pobj_bench	to_pobj_street
at_pobj_camera	on_pobj_floor	looks_nsubj_cat
through_pobj_field	riding_dobj_horse	of_pobj_people
under_pobj_bridge	on_pobj_gondola	on_pobj_river
in_pobj_pan	on_pobj_top	with_pobj_mushrooms
at_pobj_dog	of_pobj_window

on_pobj_bed
of_pobj_cars	with_pobj_lot	on_pobj_street
with_pobj_designs	holding_dobj_flowers
with_pobj_board	of_pobj_surfer	toward_pobj_ocean
in_pobj_pot
to_pobj_chair	has_dobj_television
in_pobj_cup	to_pobj_sink
kicks_nsubj_horse	kicks_dobj_legs	at_pobj_horse
with_pobj_door
of_pobj_elephant	touching_dobj_trunk	touching_nsubj_who
on_pobj_tray
of_pobj_building	on_pobj_front
enter_dobj_sign	of_pobj_it	enter_nsubj_bus	in_pobj_front	into_pobj_garage
at_pobj_themselves	in_pobj_water	picking_nsubj_seagulls
